b g f l m n o p g b b b g k g b b
b b b b b b b b b b b b b b b b b
e b b b b b b b b b b b b b b b g
g b b b b b b g g g b b b b b b i
b b b b b b b g g g b b b b b b i
b b b b b b b g g g b b b b b b g
b b b b b b b d g d b b b b b b b
b b b b b b b b b b b b b b b b b
b g h g b b b b b b b g d d g b b