b g g h g m g g b b b g g b g k g
b b b b b b b b b g b b b b b b g
g p g g b g g b b g b b g g g g g
b b b b b b o g n g g b n b b b i
g g b d g b g b b b g b b b g b b
g b b b g b g b g b g b g b g g g
g b g b b g b b g b g g g b b b d
e b g b b b b b g b b b b b g b b
g g b g i g g f g b g l g g g b h

