b g e g b b b b b b b b g k g b b
b b b b b b b b b b b b b b b b b
b b b b b b b b b b b b b b b b g
b b b b b b b h g h b b b b b b i
b b g g g g g g g g g g g g b b i
b b b b b b b d g d b b b b b b g
b b b b b b b b b b b b b b b b b
b b b b b b b b b b b b b b b b b
b g g g g o p f l m n e g g g g b